Raw Form	UPOS	proposed lemma	Remarks
اڳوڻو	ADJ	اڳوڻو
زخمي	ADJ	زخمي
ويجهو	ADP	ويجهو
هجن	AUX	آھي
هجي	AUX	آھي
هجو	AUX	آھي
هجين	AUX	آھي
هجون	AUX	آھي
هجان	AUX	آھي
هجئي	AUX	آھي
هر	NOUN	هر
واري	NOUN	وارو
پاڻي	NOUN	پاڻي
ڪوشش	NOUN	ڪوشش
ڪوڙ	NOUN	ڪوڙ
ڪي	PROPN	ڪي
ٽي	PROPN	ٽي
اين	PROPN	اين
آغا	PROPN	آغا
سگهون	VERB	سگه
سگهجي	VERB	سگهجي
