Text	UPOS	Predicted	Remarks	
آئيني	ADJ	آئيني		
آجو	ADJ	آجو		
آپگهاتي	ADJ	آپگهاتي		
اترين	ADJ	اتر		
احتجاجي	ADJ	احتجاجي		
اسلامي	ADJ	اسلامي		
اصلوڪي	ADJ	اصلوڪو		
افسوسناڪ	ADJ	افسوسناڪ		
اقتداري	ADJ	اقتداري		
الصوبائي	ADJ	الصوبائي		
الوداعي	ADJ	الوداعي		
انڌو	ADJ	انڌو		
اهڙو	ADJ	اهڙو		
اوتريون	ADJ	اوتري		
اڏامندڙ	ADJ	اڏامندڙ		
اڳين	ADJ	اڳيون		
باقائده	ADJ	باقائده		
برابر	ADJ	برابر		
برطانوي	ADJ	برطانوي		
تباهه	ADJ	تباهه		
تفريحي	ADJ	تفريحي		
تقريبن	ADJ	تقريبن		
تمام	ADJ	تمام		
جامع	ADJ	جامع		
جديد	ADJ	جديد		
جيترا	ADJ	جيترو		
جيتري	ADJ	جيتري		
حتمي	ADJ	حتمي		
خود	ADJ	خود		
خونخوار	ADJ	خونخوار		
داخل	ADJ	داخل		
رجسٽرڊ	ADJ	رجسٽرڊ		
زرخيز	ADJ	زرخيز		
زرعي	ADJ	زرعي		
سالياني	ADJ	ساليانو		
ساڳيءَ	ADJ	ساڳيءَ		
ساڳيا	ADJ	ساڳيو		
ساڳين	ADJ	ساڳيو		
ساڳيون	ADJ	ساڳي		
سطحي	ADJ	سطحي		
سنگين	ADJ	سنگين		
سول	ADJ	سول		
سويل	ADJ	سويل		
سوين	ADJ	سو		
سڌا	ADJ	سڌو		
سکڻي	ADJ	سکڻي		
سگهارو	ADJ	سگهارو		
شاندار	ADJ	شاندار		
شديد	ADJ	شديد		
شفاف	ADJ	شفاف		
طوفاني	ADJ	طوفاني		
عياشي	ADJ	عياشي		
فرائص	ADJ	فرائص		
فلسطيني	ADJ	فلسطيني		
فوت	ADJ	فوت		
قدرتي	ADJ	قدرتي		
لازوال	ADJ	لازوال		
ماتر	ADJ	ماتر		
ماتمي	ADJ	ماتمي		
متاثر	ADJ	متاثر		
متفقه	ADJ	متفقه		
متوقع	ADJ	متوقع		
مجموعي	ADJ	مجموعي		
محدود	ADJ	محدود		
مرڪزي	ADJ	مرڪزي		
مسلمان	ADJ	مسلمان		
معذور	ADJ	معذور		
منجهائي	ADJ	منجهائي	This seems verb	xf
منظم	ADJ	منظم		
مهانگو	ADJ	مهانگو		
مٿيون	ADJ	مٿي		
مٿڀرو	ADJ	مٿڀرو		
مکيه	ADJ	مکيه		
ناقابل	ADJ	ناقابل		
نامراد	ADJ	نامراد		
ناڪافي	ADJ	ناڪافي		
نجي	ADJ	نجي		
نوجوان	ADJ	نوجوان		
نيون	ADJ	نيون		
هالو	ADJ	هالو		
هاڻوڪي	ADJ	هاڻوڪو		
هرهڪ	ADJ	هرهڪ		
هلي	ADJ	هل	Seems Verb	dep
هين	ADJ	هين		
ويچاري	ADJ	ويچاري		
يقيني	ADJ	يقيني		
ٻاتيون	ADJ	ٻات		
ٻيهر	ADJ	ٻيهر		
ٻيون	ADJ	ٻي		
ٻٽي	ADJ	ٻٽي		
پارلياماني	ADJ	پارلياماني		
پاڪستاني	ADJ	پاڪستاني		
پراسرار	ADJ	پراسرار		
پرڀرو	ADJ	پرڀرو		
پنج	ADJ	پنج		
پوئتي	ADJ	پوئتي	Seems ADV	
پٺتي	ADJ	پٺتي	Seems ADV	
پڪ	ADJ	پڪ	Seems Noun	
ڀورا	ADJ	ڀورو		
چالو	ADJ	چالو		
ڏتڙيل	ADJ	ڏتڙيل		
ڏوهاري	ADJ	ڏوهارِي		
ڏينهون	ADJ	ڏينهون		
ڏيڍ	ADJ	ڏيڍ		
ڪالعدم	ADJ	ڪالعدم		
ڪنٽرولڊ	ADJ	ڪنٽرولڊ		
ڪهڙا	ADJ	ڪهڙو		
ڪيئي	ADJ	ڪيئي		
ڪچي	ADJ	ڪچي		
گهربل	ADJ	گهربل		
گهڻا	ADJ	گهڻو		
گهڻوئي	ADJ	گهڻو		
گهڻين	ADJ	گهڻي		
گڏيل	ADJ	گڏيل		
ڳڀرو	ADJ	ڳڀرو		
ڳچ	ADJ	ڳچ		
۾ڪيتريون	ADJ	۾ڪتريون	Tokenization Problem م and ڪيتريون are two separate words	fixed
اندر	ADP	اندر		
بجاءِ	ADP	بجاءِ		
جيان	ADP	جيان		
خاطر	ADP	خاطر		
في	ADP	في		
لڳ	ADP	لڳ	Seems ADV or VERRB	
وارين	ADP	واري		
واسطي	ADP	واسطي		
ويجهو	ADP	ويجهو	Seems ADV	
وچان	ADP	وچ	seems NOUN	
ڀرو	ADP	ڀرو		
ڌاري	ADP	ڌاري		
کين	ADP	کي		
الاجي	ADV	الاجي		
اوڏانهن	ADV	اوڏانهن		
اُتي	ADV	اُتي		
برقرار	ADV	برقرار		
بنهه	ADV	بنهه		
تازو	ADV	تازو	ADJ not ADV	
تيستائين	ADV	تيستائين		
جاري	ADV	جاري		
فوري	ADV	فوري		
لاشڪ	ADV	لاشڪ		
لڳاتار	ADV	لڳاتار		
هرگز	ADV	هرگز		
واقع	ADV	واقع		
يقينن	ADV	يقينو		
يڪدم	ADV	يڪدم		
ٻيهر	ADV	ٻيهر		
پهريائين	ADV	پهريائين		
چڱو	ADV	چڱو	ADJ	
ڇونه	ADV	ڇونه		
ڏي	ADV	ڏي		
ھاڻ	ADV	ھاڻ		
ناهن	AUX	ناهي		
نٿو	AUX	نٿو		
هئاسين	AUX	هئس		
ٿيا	AUX	ٿيو		
اھڙو	DET	اھڙو		
جو	DET	جو		
پاڻهي	DET	پاڻهي	PRP	
ڪوبه	DET	ڪوبه		
Copiest	NOUN	Copiest		
D.I.G	NOUN	D.I.G		
Justify	NOUN	Justify		
آبادگارن	NOUN	آبادگار		
آجيان	NOUN	آجيان		
آدرش	NOUN	آدرش		
آفيسرن	NOUN	آفيسر		
آمد	NOUN	آمد		
آمر	NOUN	آمر		
آمريت	NOUN	آمريت		
آمريڪين	NOUN	آمريڪي		
آورن	NOUN	آوري		
آڙ	NOUN	آڙ		
اتساھ	NOUN	اتساھ		
اجهي	NOUN	اجهو		
احتجاجي	NOUN	احتجاج		
اختيارين	NOUN	اختيار		
اذيت	NOUN	اذيت		
ارادو	NOUN	ارادو		
اربع	NOUN	اربع		
استقبال	NOUN	استقبال		
اسٽاپن	NOUN	اسٽاپ		
اسٽور	NOUN	اسٽور		
اسٽيجن	NOUN	اسٽيجن		
اسٽينڊنگ	NOUN	اسٽينڊنگ		
اسپيڪر	NOUN	اسپيڪر		
اسڪائوٽ	NOUN	اسڪائوٽ		
اضافو	NOUN	اضافو		
اطلاعن	NOUN	اطلاع		
اظھار	NOUN	اظھار		
اعظم	NOUN	اعظم		
افسوس	NOUN	افسوس		
السلام	NOUN	السلام		
امام	NOUN	امام		
انتقام	NOUN	انتقام		
انداز	NOUN	انداز		
اندرڊي	NOUN	اندرڊي		
انچارج	NOUN	انچارج		
انگريزيءَ	NOUN	انگريزيءَ		
انگن	NOUN	انگي		
اوجهري	NOUN	اوجهري		
اولاد	NOUN	اولاد		
اونداهي	NOUN	اونداهي		
اونڌو	NOUN	اونڌو		
ايراضي	NOUN	ايراضي		
ايل	NOUN	ايل		
ايمانداريءَ	NOUN	ايمانداريءَ		
ايوانن	NOUN	ايوان		
ايڌي	NOUN	ايڌي		
ايڪسين	NOUN	ايڪسين		
ايڪڙ	NOUN	ايڪڙ		
اي–ميل	NOUN	اي–ميل		
اُٺ	NOUN	اُٺ		
اٽارني	NOUN	اٽارني		
اٽو	NOUN	اٽو		
اٽي	NOUN	اٽي		
اپوزيشن	NOUN	اپوزيشن		
اڀياس	NOUN	اڀياس		
اچان	NOUN	اچ	VERB	
اکرن	NOUN	اکري		
اڱاري	NOUN	اڱاري		
اڳواٽ	NOUN	اڳواٽ		
اڳواڻي	NOUN	اڳواڻي		
بئراجن	NOUN	بئراجي		
بئنڪ	NOUN	بئنڪ		
بادشاهت	NOUN	بادشاهت		
باري	NOUN	باري		
بارگاهون	NOUN	بارگاه		
باطل	NOUN	باطل		
باقاعدگيءَ	NOUN	باقاعدگيءَ		
باقيات	NOUN	باقيات		
بجيٽ	NOUN	بجيٽ		
بحالي	NOUN	بحالي		
بدامني	NOUN	بدامني		
بدحالي	NOUN	بدحالي		
بدلي	NOUN	بدلي		
بدنصيبي	NOUN	بدنصيب		
برادري	NOUN	برادري		
برد	NOUN	برد		
برسات	NOUN	برسات		
برطرف	NOUN	برطرف		
بصرن	NOUN	بصر		
بعد	NOUN	بعد		
بلڊوز	NOUN	بلڊوز		
بمبار	NOUN	بمبار		
بمباري	NOUN	بمباري		
بناوت	NOUN	بناوت		
بنديون	NOUN	بندي		
بنيادن	NOUN	بنياد		
بهتريءَ	NOUN	بهتريءَ		
بورڊ	NOUN	بورڊ		
بولٽن	NOUN	بولٽن		
بيروزگاري	NOUN	بيروزگاري		
بين	NOUN	بين		
بيوروڪريسي	NOUN	بيوروڪريسي		
بيوقوفاڻيون	NOUN	بيوقفاڻين		
تباهي	NOUN	تباهي		
تباهيءَ	NOUN	تباهيءَ		
تباهين	NOUN	تباهي		
تجويزن	NOUN	تجويزو		
تحفظات	NOUN	تحفظات		
ترميمون	NOUN	ترمي		
ترن	NOUN	ترو		
تعمير	NOUN	تعمير		
تعين	NOUN	تعين		
تنظيمون	NOUN	تنظيم		
توثيق	NOUN	توثيق		
تيزيءَ	NOUN	تيزيءَ		
ثبوتن	NOUN	ثبوت		
جائز	NOUN	جائز		
جائزو	NOUN	جائزو		
جاکوڙ	NOUN	جاکوڙ		
جدوجهد	NOUN	جدوجهد		
جلسن	NOUN	جلسو		
جلوسن	NOUN	جلوس		
جناح	NOUN	جناح		
جهالت	NOUN	جهالت		
جهان	NOUN	جهان		
جهنگل	NOUN	جهنگل		
جهول	NOUN	جهول		
جواز	NOUN	جواز		
جيلاني	NOUN	جيلاني		
جڳهين	NOUN	جڳھ		
حاجي	NOUN	حاجي		
حاصلات	NOUN	حاصلات		
حالتن	NOUN	حالت		
حالتون	NOUN	حالت		
حدن	NOUN	حد		
حرف	NOUN	حرف		
حضرت	NOUN	حضرت		
حوصلو	NOUN	حوصلو		
حيرت	NOUN	حيرت		
خاتمو	NOUN	خاتمو		
خارن	NOUN	خار		
خاطر	NOUN	خاطر		
خال	NOUN	خال		
خاني	NOUN	خاني		
ختم	NOUN	ختم		
خرد	NOUN	خرد		
خطري	NOUN	خطرو		
خميس	NOUN	خميس		
خواج	NOUN	خواج		
خواجه	NOUN	خواجه		
خواهشن	NOUN	خواهش		
خودڪشيون	NOUN	خودڪشي		
دار	NOUN	دار		
دايو	NOUN	دايو		
دراندازي	NOUN	دراندزي		
دز	NOUN	دز		
دستور	NOUN	دستور		
دعوت	NOUN	دعوت		
دهشت	NOUN	دهشت		
دوائون	NOUN	دوائي		
دورا	NOUN	دورو		
دوران	NOUN	دوران		
دورو	NOUN	دورو		
دوري	NOUN	دورو		
دوڪان	NOUN	دوڪان		
ديس	NOUN	ديس		
ديوار	NOUN	ديوار		
دڙي	NOUN	دڙو		
دڳ	NOUN	دڳ		
ذميدار	NOUN	ذميدار		
ذميداريون	NOUN	ذميداري		
رائس	NOUN	رائس		
راهه	NOUN	راهه		
رايا	NOUN	رايو		
رجوع	NOUN	رجوع		
ردعمل	NOUN	ردعمل		
رمز	NOUN	رمز		
روايتن	NOUN	روايت		
روم	NOUN	روم		
روپ	NOUN	روپ		
روڪ	NOUN	روڪ		
ريسڪيو	NOUN	ريسڪيو		
ريلوي	NOUN	ريلوي		
ريلي	NOUN	ريلي		
رٽائرڊ	NOUN	رٽائرڊ		
رٽيل	NOUN	رٽيل		
رپورٽون	NOUN	رپورٽ		
رڪارڊ	NOUN	رڪارڊ		
رڪاوٽو	NOUN	رڪاوٽ		
زراعت	NOUN	زراعت		
زوال	NOUN	زوال		
سؤ	NOUN	سؤ		
سائيٽ	NOUN	سائيٽ		
ساٿي	NOUN	ساٿي		
ساک	NOUN	ساک		
ستارا	NOUN	ستارو		
سرا	NOUN	سرو		
سربراهي	NOUN	سربراهي		
سرٻاٽن	NOUN	سرٻاٽ		
سرگرمِ	NOUN	سرگرمِ		
سس	NOUN	سس		
سسٽم	NOUN	سسٽم		
سفارتخانا	NOUN	سفارتخانو		
سفارشون	NOUN	سفارش		
سفير	NOUN	سفير		
سلام	NOUN	سلام		
سلامتي	NOUN	سلامتي		
سهولتون	NOUN	سهولتون		
سوالن	NOUN	سوال		
سوسائٽي	NOUN	سوسائٽي		
سوليون	NOUN	سولي		
سوير	NOUN	سوير		
سيمينار	NOUN	سيمينار		
سينيئر	NOUN	سينيئر		
سينيٽرن	NOUN	سينيٽرن		
سينٽر	NOUN	سينٽر		
سٽون	NOUN	سٽ		
سپاھين	NOUN	سپاھ		
سڀاڻي	NOUN	سڀاڻي		
سڌارن	NOUN	سڌارو		
سکيا	NOUN	سکيو		
شاهراهه	NOUN	شاهراهه		
شرپسندن	NOUN	شرپسند		
شعور	NOUN	شعور		
شق	NOUN	شق		
شقن	NOUN	شق		
شهرت	NOUN	شهرت		
شوز	NOUN	شوز		
شڪ	NOUN	شڪ		
شڪر	NOUN	شڪر		
صحيحون	NOUN	صحيح		
صدارت	NOUN	صدارت		
ضرورتن	NOUN	ضرورت		
ضلعن	NOUN	ضلعو		
طبقن	NOUN	طبقو		
طبيعت	NOUN	طبيعت		
طوطا	NOUN	طوطو		
عاشوري	NOUN	عاشوري		
عالماڻي	NOUN	عالماڻي		
عباس	NOUN	عباس		
عدالتن	NOUN	عدالت		
عرب	NOUN	عرب		
عرصو	NOUN	عرصو		
عرف	NOUN	عرف		
عزادار	NOUN	عزادار		
عزم	NOUN	عزم		
عضوا	NOUN	عضوو		
عمارتون	NOUN	عمارت		
عهديدارن	NOUN	عهديدار		
عيوضي	NOUN	عيوضي		
غربت	NOUN	غربت		
فائدي	NOUN	فائدو		
فرد	NOUN	فرد		
فرشتن	NOUN	فرشتو		
فريب	NOUN	فريب		
فصل	NOUN	فصل		
فنڊن	NOUN	فنڊ		
فوٽو	NOUN	فوٽو		
فوڪس	NOUN	فوڪس		
ق	NOUN	ق		
قائد	NOUN	قائد		
قاتلن	NOUN	قاتل		
قافلو	NOUN	قافلو		
قافلي	NOUN	قافلو		
قبضو	NOUN	قبضو		
قبول	NOUN	قبول		
قبيلي	NOUN	قبيلي		
قدر	NOUN	قدر		
قرارداد	NOUN	قرارداد		
قربان	NOUN	قربان		
قسط	NOUN	قسط		
قميص	NOUN	قميص		
قوت	NOUN	قوت		
قوتون	NOUN	قوت		
قيد	NOUN	قيد		
قيمت	NOUN	قيمت		
قيمتون	NOUN	قيمت		
لائيٽ	NOUN	لائيٽ		
لازمي	NOUN	لازمي		
لاوو	NOUN	لاوو		
لاچار	NOUN	لاچار		
لاڳاپن	NOUN	لاڳاپو		
لسٽن	NOUN	لسٽ		
لوين	NOUN	لو		
ليفٽ	NOUN	ليفٽ		
ليڊرشپ	NOUN	ليڊرشپ		
لٽريچر	NOUN	لٽريچر		
لٽي	NOUN	لٽي		
لٽيرن	NOUN	لٽيرو		
لڏپلاڻ	NOUN	لڏپلاڻ		
لڳ	NOUN	لڳ		
ماتمي	NOUN	ماتمي		
مارٽم	NOUN	مارٽم		
مارچ	NOUN	مارچ		
مالاڪنڊ	NOUN	مالاڪنڊ		
مالي	NOUN	مالي		
مالھي	NOUN	مالھي		
مامري	NOUN	مامرو		
ماهرن	NOUN	ماهر		
ماهوار	NOUN	ماهوار		
مايوس	NOUN	مايوس		
ماڳ	NOUN	ماڳ		
ماڻھو	NOUN	ماڻھو		
متحد	NOUN	متحد		
مترجم	NOUN	مترجم		
مترجمن	NOUN	مترجم		
مجبور	NOUN	مجبور		
محترمه	NOUN	محترمه		
محرم	NOUN	محرم		
محروم	NOUN	محروم		
محرڪ	NOUN	محرڪ		
مخالفن	NOUN	مخالف		
مخدوم	NOUN	مخدوم		
مدرسا	NOUN	مدرسا		
مرحلي	NOUN	مرحلو		
مردن	NOUN	مرد		
مري	NOUN	مري		
مرڪون	NOUN	مرڪ		
مزارِ	NOUN	مزارِ		
مسئلا	NOUN	مسئلو		
مسافرن	NOUN	مسافر		
مسجدون	NOUN	مسجد		
مشتمل	NOUN	مشتمل		
مشڪل	NOUN	مشڪل		
مظاهرا	NOUN	مظاهرا		
مظلوم	NOUN	مظلوم		
مظهر	NOUN	مظهر		
معيشت	NOUN	معيشت		
مفادن	NOUN	مفادو		
مفاهمت	NOUN	مفاهمت		
ملازم	NOUN	ملازم		
ملاقاتون	NOUN	ملاقات		
ملوث	NOUN	ملوث		
ملين	NOUN	ملي		
منتقلي	NOUN	منتقل		
منظرعام	NOUN	منظرعام		
مهانڊا	NOUN	مهانڊو		
مهمانن	NOUN	مهمان		
مواصلات	NOUN	مواصلات		
موري	NOUN	موري		
موساڪي	NOUN	موساڪي		
موقف	NOUN	موقف		
ميجر	NOUN	ميجر		
ميزائل	NOUN	ميزائل		
ميزبانن	NOUN	ميزبان		
ميزباني	NOUN	ميزباني		
مينهن	NOUN	مينهن		
مينهون	NOUN	مينهون		
مينڊيٽ	NOUN	مينڊيٽ		
ميٺ	NOUN	ميٺ		
مڪمل	NOUN	مڪمل		
مگسي	NOUN	مگسي		
ناردرن	NOUN	ناردرن		
نتيجا	NOUN	نتيجو		
نر	NOUN	نر		
نشو	NOUN	نشو		
نعرو	NOUN	نعرو		
نغارا	NOUN	نغارو		
نور	NOUN	نور		
نوعيت	NOUN	نوعيت		
نير	NOUN	نير		
نيوي	NOUN	نيوي		
نگراني	NOUN	نگراني		
نگري	NOUN	نگري		
هارن	NOUN	هار		
هدايتون	NOUN	هدايت		
هضم	NOUN	هضم		
هـَرن	NOUN	هـَر		
هفتا	NOUN	هفتو		
هليري	NOUN	هليري		
همراهه	NOUN	همراهه		
هموار	NOUN	هموار		
هيليڪاپٽر	NOUN	هيليڪاپٽر		
هٿان	NOUN	هٿ		
هٿيڪو	NOUN	هٿيڪو		
واءُ	NOUN	واءُ		
وائکو	NOUN	وائکو		
وارداتن	NOUN	واردات		
وارن	NOUN	وارو		
واسين	NOUN	واسي		
واعدا	NOUN	واعدا		
والد	NOUN	والد		
واٽر	NOUN	واٽر		
واپس	NOUN	واپس		
واپسي	NOUN	واپسي		
واڌارو	NOUN	واڌارو		
واڻئي	NOUN	واڻيو		
وت	NOUN	وت		
وحشين	NOUN	وحشي		
ورندي	NOUN	ورندي		
ورکا	NOUN	ورکا		
وزارتون	NOUN	وزارت		
وزارتي	NOUN	وزارتي		
وزٽ	NOUN	وزٽ		
وفد	NOUN	وفد		
ونجهه	NOUN	ونجهه		
وندر	NOUN	وندر		
وهڪري	NOUN	وهڪرو		
ووٽن	NOUN	ووٽ		
ويب	NOUN	ويب		
ويزا	NOUN	ويزو		
ويسوڙا	NOUN	ويسوڙو		
ويـچـار	NOUN	ويـچـار		
وٿي	NOUN	وٿ		
وچن	NOUN	وچن		
وڪرو	NOUN	وڪرو		
وڪيل	NOUN	وڪيل		
يرغمال	NOUN	يرغمال		
يمن	NOUN	يمن		
ٺٺولين	NOUN	ٺٺول		
ٺڪاءَ	NOUN	ٺڪاءَ		
ٺڪاڻا	NOUN	ٺڪاڻو		
ٺڪاڻن	NOUN	ٺڪاڻو		
ٻاربي	NOUN	ٻاربي		
ٻارڙن	NOUN	ٻارڙو		
ٻوليون	NOUN	ٻول		
ٻيون	NOUN	ٻي		
ٻچا	NOUN	ٻچو		
ٻڌڻي	NOUN	ٻڌڻي		
ٻڪرين	NOUN	ٻڪر		
ٽارگيٽ	NOUN	ٽارگيٽ		
ٽاڪ	NOUN	ٽاڪ		
ٽولن	NOUN	ٽولو		
ٽولو	NOUN	ٽولو		
ٽيسٽ	NOUN	ٽيسٽ		
ٽيم	NOUN	ٽيم		
ٽپال	NOUN	ٽپال		
ٽڀو	NOUN	ٽڀو		
ٽڪار	NOUN	ٽڪار		
پابند	NOUN	پابند		
پاسپورٽ	NOUN	پاسپورٽ		
پراون	NOUN	پراون		
پرواهه	NOUN	پرواهه		
پروفيشنلز	NOUN	پروفيشنلز		
پرڏيهه	NOUN	پرڏيهه		
پرک	NOUN	پرک		
پس	NOUN	پس		
پسماندگي	NOUN	پسماندگي		
پلر	NOUN	پلر		
پناهه	NOUN	پناهه		
پني	NOUN	پني		
پورا	NOUN	پورا		
پورائو	NOUN	پورائو		
پورٽ	NOUN	پورٽ		
پيدا	NOUN	پيدا		
پيٽرسن	NOUN	پيٽرسن		
پيٽروليم	NOUN	پيٽروليم		
پيچرو	NOUN	پيچرو		
پٺي	NOUN	پٺي		
پٽاٽن	NOUN	پٽاٽو		
پٽيل	NOUN	پٽيل		
ٿيلن	NOUN	ٿيلو		
ٿڙڪڻي	NOUN	ٿڙڪڻي		
ڀ	NOUN	ڀ		
ڀائٽيي	NOUN	ڀائٽيو		
ڀر	NOUN	ڀر		
ڀرپاسي	NOUN	ڀرپاسي		
ڀٽي	NOUN	ڀٽي		
ڄـُـڪَ	NOUN	ڄـُـڪَ		
ڄڻن	NOUN	ڄڻو		
چانڊيو	NOUN	چانڊيو		
چاڙهه	NOUN	چاڙهه		
چرپر	NOUN	چرپر		
چودڳي	NOUN	چودڳو		
چوٽيون	NOUN	چوٽ		
چوڪ	NOUN	چوڪ		
چوڪي	NOUN	چوڪي		
چوڻي	NOUN	چوڻي		
چيلينج	NOUN	چيلينج		
چينل	NOUN	چينل		
چيڪ	NOUN	چيڪ		
ڇاوڻيون	NOUN	ڇاوڻي		
ڇپون	NOUN	ڇپ		
ڇڪتاڻ	NOUN	ڇڪتاڻ		
ڇڪيون	NOUN	ڇڪي		
ڊويزن	NOUN	ڊويزن		
ڊيموڪريسي	NOUN	ڊيموڪريسي		
ڊيوٽيون	NOUN	ڊيوٽي		
ڊيپوٽيشن	NOUN	ڊيپوٽيشن		
ڊپٽي	NOUN	ڊپٽي		
ڌاڙن	NOUN	ڌاڙو		
ڌرتيءَ	NOUN	ڌرتيءَ		
ڌماڪو	NOUN	ڌماڪو		
ڍءُ	NOUN	ڍءُ		
ڍؤ	NOUN	ڍؤ		
ڍانچي	NOUN	ڍانچو		
ڍُڪ	NOUN	ڍُڪ		
ڍڳيون	NOUN	ڍڳي		
ڏاٽي	NOUN	ڏاٽو		
ڏاچي	NOUN	ڏاچي		
ڏاچيءَ	NOUN	ڏاچيءَ		
ڏاڏر	NOUN	ڏاڏر		
ڏنڊي	NOUN	ڏنڊو		
ڏوهارين	NOUN	ڏوهاري		
ڏوهن	NOUN	ڏوهي		
ڏکيائون	NOUN	ڏک		
ڦال	NOUN	ڦال		
ڦر	NOUN	ڦر		
ڦرلٽ	NOUN	ڦرلٽ		
ڦهڪو	NOUN	ڦهڪو		
ڦيرڦار	NOUN	ڦيرڦار		
ڦٽين	NOUN	ڦٽي		
کاڄ	NOUN	کاڄ		
کوٽ	NOUN	کوٽ		
کوٽو	NOUN	کوٽو		
کٽيءَ	NOUN	کٽيءَ		
کڙين	NOUN	کڙي		
کڙيي	NOUN	کڙيي		
ڪئمپ	NOUN	ڪئمپ		
ڪئمپون	NOUN	ڪئمپ		
ڪائره	NOUN	ڪائره		
ڪارخانن	NOUN	ڪارخانو		
ڪارن	NOUN	ڪار		
ڪارواين	NOUN	ڪاروائي		
ڪارپوريشن	NOUN	ڪارپوريشن		
ڪارڪردگي	NOUN	ڪارڪردگي		
ڪارڪن	NOUN	ڪارڪن		
ڪامورا	NOUN	ڪامورو		
ڪامورن	NOUN	ڪامورو		
ڪانفرنس	NOUN	ڪانفرنس		
ڪاني	NOUN	ڪاني		
ڪانٽريڪٽ	NOUN	ڪانٽريڪٽ		
ڪتا	NOUN	ڪتو		
ڪتابن	NOUN	ڪتاب		
ڪرت	NOUN	ڪرت		
ڪـُـن	NOUN	ڪـُـن		
ڪلنٽن	NOUN	ڪلنٽن		
ڪلهن	NOUN	ڪلهي		
ڪنب	NOUN	ڪنب		
ڪنن	NOUN	ڪنن		
ڪنيڪشن	NOUN	ڪنيڪشن		
ڪنڊ	NOUN	ڪنڊ		
ڪنڍي	NOUN	ڪنڍي		
ڪورس	NOUN	ڪورس		
ڪوششون	NOUN	ڪوشش		
ڪوٽا	NOUN	ڪوٽا		
ڪيري	NOUN	ڪيري		
ڪڙڇ	NOUN	ڪڙڇ		
گئس	NOUN	گئس		
گاديءَ	NOUN	گاديءَ		
گاوڙ	NOUN	گاوڙ		
گاڏيون	NOUN	گاڏي		
گداڙي	NOUN	گداڙي		
گراف	NOUN	گراف		
گرام	NOUN	گرام		
گرم	NOUN	گرم		
گروهن	NOUN	گروھ		
گـُـڙ	NOUN	گـُـڙ		
گم	NOUN	گم		
گمان	NOUN	گمان		
گنج	NOUN	گنج		
گهيڙ	NOUN	گهيڙ		
گوسڙو	NOUN	گوسڙو		
گولين	NOUN	گولي		
گوليون	NOUN	گولي		
گوپانگ	NOUN	گوپانگ		
گيج	NOUN	گيج		
گڏجاڻي	NOUN	گڏجاڻِي		
ڳالهين	NOUN	ڳاهه		
ڳاڙهو	NOUN	ڳاڙهو		
ڳجها	NOUN	ڳجهو		
ڳوٺاڻن	NOUN	ڳوٺاڻو		
ڳوٺاڻو	NOUN	ڳوٺاڻو		
ڳڀي	NOUN	ڳڀ		
ڳڙهي	NOUN	ڳڙهي		
ھوٽل	NOUN	ھوٽل		
100	NUM	100		
118	NUM	118		
125	NUM	125		
150	NUM	150		
18	NUM	18		
1973ع	NUM	1973		
1974ع	NUM	1974		
2002ع	NUM	2002		
2003ع	NUM	2003		
2008ع	NUM	2008		
21	NUM	21		
29	NUM	29		
31	NUM	31		
40	NUM	40		
45	NUM	45		
66	NUM	66		
74	NUM	74		
81	NUM	81		
980	NUM	980		
سوا	NUM	سوا		
چئين	NUM	چار		
ڏهين	NUM	ڏھ		
اُهي	PRON	اُهي		
تيئن	PRON	تي		
جي	PRON	جي		
جيئن	PRON	جيئن		
سـو	PRON	سـو		
سنڌي	PRON	سنڌي		
پنهنجون	PRON	پنهنجو		
پنھنجو	PRON	پنھنجو		
پنھنجي	PRON	پنھنجو		
ڪن	PRON	ڪو		
ڪوئي	PRON	ڪو		
ڪيئن	PRON	ڪيئن		
ڪڏهن	PRON	ڪڏهن		
ھن	PRON	ھي		
UK	PROPN	UK		
آءِ	PROPN	آءِ		
آر	PROPN	آر		
آفريڪا	PROPN	آفريڪا		
اربين	PROPN	اربين	seems NOUN	
اطهر	PROPN	اطهر		
اعظم	PROPN	اعظم		
الحق	PROPN	الحق		
الزمان	PROPN	الزمان		
امتياز	PROPN	امتياز		
امراءُ	PROPN	امراءُ		
امين	PROPN	امين		
انگرادوس	PROPN	انگرادوس		
اياز	PROPN	اياز		
ايريا	PROPN	ايريا		
ايس	PROPN	ايس		
اينگلو	PROPN	اينگلو		
ايٿوپيا	PROPN	ايٿوپيا		
بخت	PROPN	بخت		
بختيار	PROPN	بختيار		
برازيل	PROPN	برازيل		
تصدق	PROPN	تصدق		
جاتي	PROPN	جاتي		
جدي	PROPN	جدي		
جرادت	PROPN	جرادت		
جواد	PROPN	جواد		
حسن	PROPN	حسن		
حنادي	PROPN	حنادي		
خيرو	PROPN	خيرو		
راولپنڊي	PROPN	راولپنڊي		
روغا	PROPN	روغو		
رومن	PROPN	روم		
روهڙي	PROPN	روهڙي		
سئڪسن	PROPN	سئڪسن		
سارو	PROPN	سارو		
سروڪئي	PROPN	سروڪئي		
سعودي	PROPN	سعودي		
سهيل	PROPN	سهيل		
سوات	PROPN	سوات		
ش	PROPN	ش		
صادق	PROPN	صادق		
صديق	PROPN	صديق		
طارق	PROPN	طارق		
عبدالوحيد	PROPN	عبدالوحيد		
عبدالوهاب	PROPN	عبدالوهاب		
عليه	PROPN	عليه		
فهميده	PROPN	فهميده		
فيبروري	PROPN	فيبروري		
فيض	PROPN	فيض		
قائد	PROPN	قائد		
قائم	PROPN	قائم		
قاضي	PROPN	قاضي		
قمر	PROPN	قمر		
لال	PROPN	لال		
لوگر	PROPN	لوگر		
مختيار	PROPN	مختيار		
مظھر	PROPN	مظھر		
ملتان	PROPN	ملتاو		
منڊو	PROPN	منڊو		
مٽياري	PROPN	مٽياري		
مڪين	PROPN	مڪين		
نند	PROPN	نند		
هاءِ	PROPN	هاءِ		
هالا	PROPN	هاللو		
هوٽل	PROPN	هوٽل		
ورلڊ	PROPN	ورلڊ		
يعقوب	PROPN	يعقوب		
پي	PROPN	پي		
پيارو	PROPN	پيارو		
پيرمظهرالحق	PROPN	پيرمظهرالحق		
ڀٽ	PROPN	ڀٽ		
ڇنڇر	PROPN	ڇنڇر		
ڊبليو	PROPN	ڊبليو		
ڌاٻيجي	PROPN	ڌاٻيجي		
کيبر	PROPN	کيبر		
ڪالاباغ	PROPN	ڪالاباغ		
ڪربلا	PROPN	ڪربلا		
ڪشمالا	PROPN	ڪشمالا		
ڪنڌڪوٽ	PROPN	ڪنڌڪوٽ		
ڪوئيٽا	PROPN	ڪوئيٽا		
گهرام	PROPN	گهرام		
(	PUNCT	(		
)	PUNCT	)		
-	PUNCT	-		
/	PUNCT	/		
:	PUNCT	:		
،	PUNCT	،		
؟	PUNCT	؟		
“	PUNCT	“		
”	PUNCT	”		
ايترا	SCONJ	ايترو	seems ADJ	
بلڪه	SCONJ	بلڪه		
جي	SCONJ	جي		
جيتوڻيڪ	SCONJ	جيتوڻيڪ		
ڇو	SCONJ	ڇو		
آڻيندي	VERB	آڻ		
اسمگل	VERB	اسمگل		
الپن	VERB	الپ		
اماڻي	VERB	اماڻ		
اماڻيندا	VERB	اماڻ		
اينداسين	VERB	ايندو		
ايندس	VERB	ايندو		
اُڪري	VERB	اُڪر		
اڀري	VERB	اڀر		
اچاري	VERB	اچار		
اچجانءِ	VERB	اچج		
اچيو	VERB	اچ		
اچڻو	VERB	اچ		
اڇلي	VERB	اڇل		
اڏائي	VERB	اڏاءِ		
اڏايو	VERB	اڏاءِ		
بنائڻ	VERB	بناءِ		
بنايون	VERB	بنائي		
بچڻ	VERB	بچ		
بڻائڻ	VERB	بڻاءِ		
بڻجن	VERB	بڻج		
بڻجيو	VERB	بڻج		
ترسڻ	VERB	تر		
ترڪي	VERB	ترڪي		
ته:	VERB	ته:	Tokenization error ته and ":" are separate ته is SCONJ 	fixed
جوڙيندي	VERB	جوڙ		
خمارجيو	VERB	خمارجيو		
رنگجي	VERB	رنگج		
رهـيـو	VERB	رهـ		
رهنديون	VERB	رهـ		
رهيون	VERB	رهـ		
روانا	VERB	روانو		
رواني	VERB	رواني		
روڪيو	VERB	روڪ		
رکيا	VERB	رک		
رکيل	VERB	رک		
رڪجندا	VERB	رڪج		
رھيا	VERB	رھ		
ساڙيا	VERB	ساڙ		
سمجهڻ	VERB	سمجھڻ		
سمجهڻو	VERB	سمجهڻ		
سيٽجي	VERB	سيٽج		
سڌرڻ	VERB	سڌر		
سڻائو	VERB	سڻاءِ		
شامل	VERB	شامل		
فراهم	VERB	فراهم		
لنگهيو	VERB	لنگه		
لنگهڻ	VERB	لنگھ		
لٽي	VERB	لٽ		
لکجڻ	VERB	لکج		
لڳائبا	VERB	لڳائبو		
مئا	VERB	مئو		
مارجڻ	VERB	مارجڻ		
ماريو	VERB	مار		
ماپڻ	VERB	ماپ		
ماڻڻ	VERB	ماڻ		
مـَـهٽي	VERB	مـَـهٽي		
مليون	VERB	مل		
موڪليون	VERB	موڪل		
مٽجي	VERB	مٽج		
مڃجي	VERB	مڃج		
مڃيو	VERB	مڃ		
مچائڻ	VERB	مچاءِ		
نچو	VERB	نچو		
نڪتل	VERB	نڪتل		
هراسجي	VERB	هراسجيو		
هلجي	VERB	هلج		
هلو	VERB	هل		
هلون	VERB	ھل		
وجهائيندا	VERB	وجهاءِ		
ورتس	VERB	ورتو		
ورتيون	VERB	ورتو		
ونڊائڻو	VERB	ونڊڻ		
وهڻ	VERB	وهڻ		
ويـهـي	VERB	ويـهـ		
ويندڙ	VERB	ويندو		
ويوجنهن	VERB	ويونهون	Tokenization error 	fixed
وٺرائيندڙ	VERB	وٺراءِ		
وٺڻو	VERB	وٺ		
وڃڻي	VERB	وڃ		
وڌندي	VERB	وڌ		
ٺاهيندڙ	VERB	ٺاه		
ٺاهيندڙن	VERB	ٺاه		
ٺهرايو	VERB	ٺهراءِ		
ٺهيل	VERB	ٺهيو		
ٻولي	VERB	ٻولي		
ٻيٺاهين	VERB	ٻيٺ		
ٻڌايا	VERB	ٻڌاءِ		
ٻڌل	VERB	ٻڌ		
ٻڏڻ	VERB	ٻڏ		
ٽاهي	VERB	ٽاه		
ٽپي	VERB	ٽپ		
پار	VERB	پار		
پرکي	VERB	پرک		
پون	VERB	پون		
پيئندا	VERB	پيءَ		
پيئڻ	VERB	پيءَ		
پچي	VERB	پچ		
پڇائيندا	VERB	پڇاءِ		
پڙهائبو	VERB	پڙهائبو		
پکڙجي	VERB	پکڙ		
پکڙيل	VERB	پکڙو		
پڪڙي	VERB	پڪڙ		
پھچايو	VERB	پھچاءِ		
ٿيس	VERB	ٿي		
ٿيم	VERB	ٿيو		
ٿيڻو	VERB	ٿي		
ڀڳي	VERB	ڀڳ		
ڄاڻجو	VERB	ڄاڻ		
ڄاڻڻ	VERB	ڄاڻ		
چئبو	VERB	چئبو		
چئجي	VERB	چئج		
چاهيان	VERB	چاه		
چاهيون	VERB	چاه		
چتائي	VERB	چتاءِ		
چميا	VERB	چم		
چوري	VERB	چوري		
چونڊيل	VERB	چونڊيل		
چڪا	VERB	چڪو		
چڪي	VERB	چڪو		
ڇڏائڻ	VERB	ڇڏ		
ڇڏيانءِ	VERB	ڇڏي		
ڇڏيندڙ	VERB	ڇڏ		
ڊاهي	VERB	ڊاه		
ڊاهڻ	VERB	ڊاه		
ڊهي	VERB	ڊه		
ڏسانس	VERB	ڏس		
ڏهڪايل	VERB	ڏهڪايو		
ڏيندڙ	VERB	ڏيندو		
ڏيکاريانوَ	VERB	ڏيکار		
ڏيکاريندڙ	VERB	ڏيکار		
ڏيکارڻ	VERB	ڏيکاءِ		
ڏيڻي	VERB	ڏيڻ		
ڏٺائين	VERB	ڏٺاءِ		
ڏٺيون	VERB	ڏٺو		
ڦاٽو	VERB	ڦاٽو		
ڦاٽي	VERB	ڦاٽ		
ڦاٿل	VERB	ڦاٿو		
ڦاڙي	VERB	ڦاڙ		
ڦاڙيو	VERB	ڦاڙ		
ڦرن	VERB	ڦر		
ڦهلائيندڙ	VERB	ڦهلاء		
ڦٿڪي	VERB	ڦٿڪ		
کانپو	VERB	کان	Seems ADP	xf
کاڌي	VERB	کاڌي		
کليل	VERB	کليو		
کنئي	VERB	کڻ		
کولرائڻ	VERB	کول		
کولڻ	VERB	کول		
ڪبيون	VERB	ڪبو		
ڪرڻا	VERB	ڪرڻو		
ڪونهن	VERB	ڪونهي		
ڪوٺايل	VERB	ڪوٺايل		
ڪيرائڻو	VERB	ڪيراءِ		
ڪٽي	VERB	ڪٽي		
ڪپي	VERB	ڪپي		
ڪڍيو	VERB	ڪڍ		
گذار	VERB	گذار		
گسائڻ	VERB	گساءِ		
گهرن	VERB	گهر		
ڳنڍيل	VERB	ڳنڍي		
ڳولهي	VERB	ڳوله		
۾	VERB	۾		