Raw	POS	Lemma
آخري	ADJ	آخري
آزاد	ADJ	آزاد
آمريڪي	ADJ	آمريڪي
ادبي	ADJ	ادبي
اصل	ADJ	اصل
الڳ	ADJ	الڳ
انتهائي	ADJ	انتهائي
انساني	ADJ	انساني
اهم	ADJ	اهم
اهڙا	ADJ	اهڙا
اهڙن	ADJ	اهڙن
اهڙي	ADJ	اهڙي
اهڙيءَ	ADJ	اهڙيءَ
ايترا	ADJ	ايترا
ايترو	ADJ	ايترو
ايتري	ADJ	ايتري
اڌ	ADJ	اڌ
اڳوڻي	ADJ	اڳوڻي
باقي	ADJ	باقي
برقرار	ADJ	برقرار
بيگاري	ADJ	بيگاري
تخليقي	ADJ	تخليقي
تيار	ADJ	تيار
تيز	ADJ	تيز
جمهوري	ADJ	جمهوري
جهڙي	ADJ	جهڙي
جوڊيشل	ADJ	جوڊيشل
حيران	ADJ	حيران
حڪومتي	ADJ	حڪومتي
خالي	ADJ	خالي
خطرناڪ	ADJ	خطرناڪ
خودڪش	ADJ	خودڪش
خوفناڪ	ADJ	خوفناڪ
رڳو	ADJ	رڳو
سرڪاري	ADJ	سرڪاري
سمورن	ADJ	سمورن
سموري	ADJ	سموري
سميت	ADJ	سميت
سياسي	ADJ	سياسي
سپريم	ADJ	سپريم
سڄو	ADJ	سڄو
صحيح	ADJ	صحيح
صرف	ADJ	صرف
صوبائي	ADJ	صوبائي
ضروري	ADJ	ضروري
عام	ADJ	عام
عوامي	ADJ	عوامي
غذائي	ADJ	غذائي
غير	ADJ	غير
فقط	ADJ	فقط
قائم	ADJ	قائم
لڳ	ADJ	لڳ
مخالف	ADJ	مخالف
مضبوط	ADJ	مضبوط
معاشي	ADJ	معاشي
مقامي	ADJ	مقامي
ملڪي	ADJ	ملڪي
موجوده	ADJ	موجوده
مڪاني	ADJ	مڪاني
نئون	ADJ	نئون
ننڍي	ADJ	ننڍي
ننڍڙي	ADJ	ننڍڙي
نوڪدار	ADJ	نوڪدار
هر	ADJ	هر
هزارين	ADJ	هزارين
هيءُ	ADJ	هيءُ
هڪ	ADJ	هڪ
هڪڙو	ADJ	هڪڙو
هڪڙي	ADJ	هڪڙي
واضح	ADJ	واضح
وفاقي	ADJ	وفاقي
ٺيڪ	ADJ	ٺيڪ
ٻئي	ADJ	ٻئي
ٻاراڻو	ADJ	ٻاراڻو
ٻن	ADJ	ٻن
ٻنهي	ADJ	ٻنهي
ٻه	ADJ	ٻه
ٻي	ADJ	ٻي
ٻيا	ADJ	ٻيا
ٻين	ADJ	ٻين
ٻيو	ADJ	ٻيو
ٽي	ADJ	ٽي
پراڻي	ADJ	پراڻي
پرڏيهي	ADJ	پرڏيهي
پهرين	ADJ	پهرين
پهريون	ADJ	پهريون
پورو	ADJ	پورو
پوڙهي	ADJ	پوڙهي
ٿورن	ADJ	ٿورن
ٿورو	ADJ	ٿورو
ٿوري	ADJ	ٿوري
ٿوريءَ	ADJ	ٿوريءَ
چڱي	ADJ	چڱي
چڱيءَ	ADJ	چڱيءَ
ڪابه	ADJ	ڪابه
ڪافي	ADJ	ڪافي
ڪجهه	ADJ	ڪجهه
ڪمزور	ADJ	ڪمزور
ڪيترا	ADJ	ڪيترا
ڪيترائي	ADJ	ڪيترائي
ڪيترو	ADJ	ڪيترو
ڪيتريون	ADJ	ڪيتريون
گهٽ	ADJ	گهٽ
گهڻو	ADJ	گهڻو
گهڻي	ADJ	گهڻي
ڳاڙهي	ADJ	ڳاڙهي
ھڪ	ADJ	ھڪ
ئي	ADP	ئي
بابت	ADP	بابت
باوجود	ADP	باوجود
بعد	ADP	بعد
تحت	ADP	تحت
جيڪڏهن	ADP	جيڪڏهن
خلاف	ADP	خلاف
دوران	ADP	دوران
سبب	ADP	سبب
طرفان	ADP	طرفان
مطابق	ADP	مطابق
موجب	ADP	موجب
وارا	ADP	وارا
وارن	ADP	وارن
واريون	ADP	واريون
وانگر	ADP	وانگر
وٽان	ADP	وٽان
يعني	ADP	يعني
پاران	ADP	پاران
پوءِ	ADP	پوءِ
پڻ	ADP	پڻ
ڀرسان	ADP	ڀرسان
کن	ADP	کن
کيس	ADP	کيس
ڪري	ADP	ڪري
آهستي	ADV	آهستي
آڏو	ADV	آڏو
اتان	ADV	اتان
اتي	ADV	اتي
اندر	ADV	اندر
اوچتو	ADV	اوچتو
ايئن	ADV	ايئن
ايترو	ADV	ايترو
اڃا	ADV	اڃا
اڳتي	ADV	اڳتي
اڳيان	ADV	اڳيان
بجاءِ	ADV	بجاءِ
بدران	ADV	بدران
بلڪه	ADV	بلڪه
بهرحال	ADV	بهرحال
تنهنڪري	ADV	تنهنڪري
توڙي	ADV	توڙي
جتي	ADV	جتي
جهڙو	ADV	جهڙو
جيڪڏهن	ADV	جيڪڏهن
جڏهن	ADV	جڏهن
سامهون	ADV	سامهون
سواءِ	ADV	سواءِ
شايد	ADV	شايد
لاءِ	ADV	لاءِ
متان	ADV	متان
موجود	ADV	موجود
مٿان	ADV	مٿان
مٿي	ADV	مٿي
نيٺ	ADV	نيٺ
هاڻ	ADV	هاڻ
هتان	ADV	هتان
هتي	ADV	هتي
هوڏانهن	ADV	هوڏانهن
هيٺ	ADV	هيٺ
هيٺان	ADV	هيٺان
هيڏانهن	ADV	هيڏانهن
هڪدم	ADV	هڪدم
وانگر	ADV	وانگر
واپس	ADV	واپس
ويجهو	ADV	ويجهو
وچان	ADV	وچان
ٻاهر	ADV	ٻاهر
پري	ADV	پري
پويان	ADV	پويان
پٺيان	ADV	پٺيان
ڀلا	ADV	ڀلا
ڄڻ	ADV	ڄڻ
ڇاڪاڻ	ADV	ڇاڪاڻ
ڏانهن	ADV	ڏانهن
ڪالهه	ADV	ڪالهه
ڪٿي	ADV	ڪٿي
آهيان	AUX	آهيان
آھن	AUX	آھن
آھي	AUX	آھي
سگهان	AUX	سگهان
سگهن	AUX	سگهن
سگهي	AUX	سگهي
سگهيو	AUX	سگهيو
ناهي	AUX	ناهي
ها	AUX	ها
هو	AUX	هو
هيون	AUX	هيون
ٿا	AUX	ٿا
ٿو	AUX	ٿو
ٿي	AUX	ٿي
ٿيون	AUX	ٿيون
توڙي	CCONJ	توڙي
يا	CCONJ	يا
اسان	DET	اسان
انهي	DET	انهي
انهيءَ	DET	انهيءَ
اهڙي	DET	اهڙي
هو	DET	هو
هيءَ	DET	هيءَ
هيءُ	DET	هيءُ
پنهنجي	DET	پنهنجي
ڪا	DET	ڪا
ھن	DET	ھن
آءِ	NOUN	آءِ
آئين	NOUN	آئين
آبپاشي	NOUN	آبپاشي
آخر	NOUN	آخر
آر	NOUN	آر
آرڊيننس	NOUN	آرڊيننس
آسمان	NOUN	آسمان
آغا	NOUN	آغا
آفت	NOUN	آفت
آفيس	NOUN	آفيس
آفيسر	NOUN	آفيسر
آن	NOUN	آن
آواز	NOUN	آواز
آپريشن	NOUN	آپريشن
آڱر	NOUN	آڱر
اتفاق	NOUN	اتفاق
اجازت	NOUN	اجازت
احتجاج	NOUN	احتجاج
احتساب	NOUN	احتساب
اختيار	NOUN	اختيار
استادن	NOUN	استادن
اسيمبلي	NOUN	اسيمبلي
اسپتال	NOUN	اسپتال
اسڪولن	NOUN	اسڪولن
اشارو	NOUN	اشارو
اطلاع	NOUN	اطلاع
اعتماد	NOUN	اعتماد
اعلان	NOUN	اعلان
اعليٰ	NOUN	اعليٰ
اغوا	NOUN	اغوا
اقتدار	NOUN	اقتدار
امان	NOUN	امان
اميد	NOUN	اميد
امير	NOUN	امير
انتظار	NOUN	انتظار
انتظام	NOUN	انتظام
انتظاميا	NOUN	انتظاميا
انجام	NOUN	انجام
انڪار	NOUN	انڪار
انگ	NOUN	انگ
او	NOUN	او
اوز	NOUN	اوز
اي	NOUN	اي
ايس	NOUN	ايس
ايف	NOUN	ايف
ايم	NOUN	ايم
اين	NOUN	اين
ايوارڊ	NOUN	ايوارڊ
ايڇ	NOUN	ايڇ
اکيون	NOUN	اکيون
اڳ	NOUN	اڳ
اڳواڻ	NOUN	اڳواڻ
اڳواڻن	NOUN	اڳواڻن
بئراج	NOUN	بئراج
بادشاهه	NOUN	بادشاهه
باندرن	NOUN	باندرن
باهه	NOUN	باهه
بحث	NOUN	بحث
بخش	NOUN	بخش
بدن	NOUN	بدن
بريفنگ	NOUN	بريفنگ
بس	NOUN	بس
بل	NOUN	بل
بم	NOUN	بم
بند	NOUN	بند
بندن	NOUN	بندن
بنياد	NOUN	بنياد
بي	NOUN	بي
بيان	NOUN	بيان
بچاءُ	NOUN	بچاءُ
بک	NOUN	بک
تباهه	NOUN	تباهه
تبديل	NOUN	تبديل
تبديلي	NOUN	تبديلي
تحريڪ	NOUN	تحريڪ
ترجمان	NOUN	ترجمان
ترجمو	NOUN	ترجمو
ترجمي	NOUN	ترجمي
ترميم	NOUN	ترميم
تسليم	NOUN	تسليم
تشدد	NOUN	تشدد
تصوير	NOUN	تصوير
تعلق	NOUN	تعلق
تعلقي	NOUN	تعلقي
تفصيل	NOUN	تفصيل
تمراڻي	NOUN	تمراڻي
توب	NOUN	توب
تيار	NOUN	تيار
تڪرار	NOUN	تڪرار
جاءِ	NOUN	جاءِ
جادوءَ	NOUN	جادوءَ
جانور	NOUN	جانور
جانورن	NOUN	جانورن
جانچ	NOUN	جانچ
جج	NOUN	جج
ججن	NOUN	ججن
جسٽس	NOUN	جسٽس
جلد	NOUN	جلد
جلوس	NOUN	جلوس
جمهوريت	NOUN	جمهوريت
جنرل	NOUN	جنرل
جنم	NOUN	جنم
جنگ	NOUN	جنگ
جهنگ	NOUN	جهنگ
جهوپڙيءَ	NOUN	جهوپڙيءَ
جواب	NOUN	جواب
جوابدار	NOUN	جوابدار
جوابدارن	NOUN	جوابدارن
جي	NOUN	جي
جيل	NOUN	جيل
حال	NOUN	حال
حساب	NOUN	حساب
حصو	NOUN	حصو
حصي	NOUN	حصي
حل	NOUN	حل
حمايت	NOUN	حمايت
حملن	NOUN	حملن
حملو	NOUN	حملو
حملي	NOUN	حملي
حوالي	NOUN	حوالي
حڪم	NOUN	حڪم
حڪمراني	NOUN	حڪمراني
حڪومتن	NOUN	حڪومتن
خان	NOUN	خان
خاندان	NOUN	خاندان
خريد	NOUN	خريد
خطاب	NOUN	خطاب
خوراڪ	NOUN	خوراڪ
خوشحالي	NOUN	خوشحالي
خوشيءَ	NOUN	خوشيءَ
خير	NOUN	خير
دائي	NOUN	دائي
دانهن	NOUN	دانهن
دانهون	NOUN	دانهون
درخواست	NOUN	درخواست
دروازي	NOUN	دروازي
درياءَ	NOUN	درياءَ
دشمن	NOUN	دشمن
دشمني	NOUN	دشمني
دير	NOUN	دير
ديوتا	NOUN	ديوتا
ديوتائن	NOUN	ديوتائن
دٻاءُ	NOUN	دٻاءُ
ذريعن	NOUN	ذريعن
راءِ	NOUN	راءِ
رابطو	NOUN	رابطو
راجا	NOUN	راجا
راز	NOUN	راز
راڄ	NOUN	راڄ
راڳ	NOUN	راڳ
رت	NOUN	رت
رد	NOUN	رد
رستي	NOUN	رستي
رقم	NOUN	رقم
روز	NOUN	روز
روڊ	NOUN	روڊ
ريت	NOUN	ريت
رينجرز	NOUN	رينجرز
رپورٽ	NOUN	رپورٽ
رپيا	NOUN	رپيا
رپين	NOUN	رپين
رڙ	NOUN	رڙ
رڙيون	NOUN	رڙيون
زرداري	NOUN	زرداري
زماني	NOUN	زماني
زندگيءَ	NOUN	زندگيءَ
سائين	NOUN	سائين
ساراهه	NOUN	ساراهه
سالن	NOUN	سالن
سامهون	NOUN	سامهون
سانڊي	NOUN	سانڊي
ساهه	NOUN	ساهه
سبب	NOUN	سبب
سر	NOUN	سر
سربراهه	NOUN	سربراهه
سرحد	NOUN	سرحد
سردار	NOUN	سردار
سرڪار	NOUN	سرڪار
سطح	NOUN	سطح
سفر	NOUN	سفر
سلامت	NOUN	سلامت
سلسلو	NOUN	سلسلو
سلسلي	NOUN	سلسلي
سماج	NOUN	سماج
سمجهه	NOUN	سمجهه
سنڀال	NOUN	سنڀال
سنڌي	NOUN	سنڌي
سهراب	NOUN	سهراب
سوار	NOUN	سوار
سوال	NOUN	سوال
سوتون	NOUN	سوتون
سور	NOUN	سور
سومرو	NOUN	سومرو
سي	NOUN	سي
سياسي	NOUN	سياسي
سيد	NOUN	سيد
سيشن	NOUN	سيشن
سيڊا	NOUN	سيڊا
سيڪريٽري	NOUN	سيڪريٽري
سيڪيورٽي	NOUN	سيڪيورٽي
سيڪڙو	NOUN	سيڪڙو
شامل	NOUN	شامل
شاهه	NOUN	شاهه
شخص	NOUN	شخص
شروع	NOUN	شروع
شروعات	NOUN	شروعات
شريف	NOUN	شريف
شرڪت	NOUN	شرڪت
شهري	NOUN	شهري
شهرين	NOUN	شهرين
شهزاديءَ	NOUN	شهزاديءَ
شهيد	NOUN	شهيد
شهيدن	NOUN	شهيدن
شيخ	NOUN	شيخ
شير	NOUN	شير
شين	NOUN	شين
شينهن	NOUN	شينهن
شينهڻ	NOUN	شينهڻ
شيون	NOUN	شيون
شڪار	NOUN	شڪار
شڪست	NOUN	شڪست
شگر	NOUN	شگر
صحافين	NOUN	صحافين
صدر	NOUN	صدر
صلاح	NOUN	صلاح
صوبن	NOUN	صوبن
صوبي	NOUN	صوبي
صورت	NOUN	صورت
صوفي	NOUN	صوفي
ضرور	NOUN	ضرور
ضلعي	NOUN	ضلعي
طرح	NOUN	طرح
طرف	NOUN	طرف
طرفان	NOUN	طرفان
طريقيڪار	NOUN	طريقيڪار
طور	NOUN	طور
طوطي	NOUN	طوطي
ظاهر	NOUN	ظاهر
عجب	NOUN	عجب
عدالت	NOUN	عدالت
عرض	NOUN	عرض
عقل	NOUN	عقل
علائقن	NOUN	علائقن
عمارت	NOUN	عمارت
عمر	NOUN	عمر
عملدار	NOUN	عملدار
عملدارن	NOUN	عملدارن
عوام	NOUN	عوام
عورتن	NOUN	عورتن
غلطي	NOUN	غلطي
غور	NOUN	غور
غير	NOUN	غير
فائدو	NOUN	فائدو
فائرنگ	NOUN	فائرنگ
فقير	NOUN	فقير
فنڊ	NOUN	فنڊ
فوج	NOUN	فوج
فوجي	NOUN	فوجي
فورسز	NOUN	فورسز
فيصلو	NOUN	فيصلو
فيلبان	NOUN	فيلبان
قدم	NOUN	قدم
قرار	NOUN	قرار
قسمت	NOUN	قسمت
قيدين	NOUN	قيدين
لائن	NOUN	لائن
لاش	NOUN	لاش
لانگ	NOUN	لانگ
لاڪپ	NOUN	لاڪپ
لهر	NOUN	لهر
ليز	NOUN	ليز
ليگ	NOUN	ليگ
لک	NOUN	لک
مائيءَ	NOUN	مائيءَ
مارڪيٽ	NOUN	مارڪيٽ
ماضي	NOUN	ماضي
مالياتي	NOUN	مالياتي
ماليڪٽ	NOUN	ماليڪٽ
مالڪ	NOUN	مالڪ
مانيٽرنگ	NOUN	مانيٽرنگ
ماهي	NOUN	ماهي
ماٺ	NOUN	ماٺ
ماڻهوءَ	NOUN	ماڻهوءَ
متاثر	NOUN	متاثر
متاثرن	NOUN	متاثرن
محسوس	NOUN	محسوس
محل	NOUN	محل
مذمت	NOUN	مذمت
مرضي	NOUN	مرضي
مرڪز	NOUN	مرڪز
مسئلن	NOUN	مسئلن
مسئلو	NOUN	مسئلو
مستقبل	NOUN	مستقبل
مسلم	NOUN	مسلم
مطلب	NOUN	مطلب
مظاهرو	NOUN	مظاهرو
معاملن	NOUN	معاملن
معاملي	NOUN	معاملي
معنيٰ	NOUN	معنيٰ
مقبوليت	NOUN	مقبوليت
مقرر	NOUN	مقرر
مقصد	NOUN	مقصد
ملاقات	NOUN	ملاقات
منظور	NOUN	منظور
منهن	NOUN	منهن
مهينن	NOUN	مهينن
مهيني	NOUN	مهيني
موقعي	NOUN	موقعي
ميان	NOUN	ميان
ميل	NOUN	ميل
ميلو	NOUN	ميلو
ميمبرن	NOUN	ميمبرن
ميمڻ	NOUN	ميمڻ
ميڊيا	NOUN	ميڊيا
مٽي	NOUN	مٽي
مٿي	NOUN	مٿي
مڇين	NOUN	مڇين
مڇيون	NOUN	مڇيون
مڪاٽو	NOUN	مڪاٽو
ن	NOUN	ن
ناظم	NOUN	ناظم
ناظمن	NOUN	ناظمن
نالو	NOUN	نالو
نالي	NOUN	نالي
نانگ	NOUN	نانگ
ناڻي	NOUN	ناڻي
نتيجو	NOUN	نتيجو
نتيجي	NOUN	نتيجي
نسل	NOUN	نسل
نشانو	NOUN	نشانو
نقصان	NOUN	نقصان
نمائندن	NOUN	نمائندن
نموني	NOUN	نموني
نوٽيفڪيشن	NOUN	نوٽيفڪيشن
نوڪر	NOUN	نوڪر
هاءِ	NOUN	هاءِ
هائوس	NOUN	هائوس
هزار	NOUN	هزار
هنڌ	NOUN	هنڌ
هٿياربندن	NOUN	هٿياربندن
وات	NOUN	وات
وارثن	NOUN	وارثن
واقعن	NOUN	واقعن
واقعو	NOUN	واقعو
واقعي	NOUN	واقعي
والدين	NOUN	والدين
واهه	NOUN	واهه
واپاري	NOUN	واپاري
واڌ	NOUN	واڌ
وجهه	NOUN	وجهه
ورڇ	NOUN	ورڇ
وزارت	NOUN	وزارت
وزيراعظم	NOUN	وزيراعظم
وزيراعليٰ	NOUN	وزيراعليٰ
وطن	NOUN	وطن
وفاق	NOUN	وفاق
وي	NOUN	وي
ويڙهه	NOUN	ويڙهه
وچ	NOUN	وچ
وڳي	NOUN	وڳي
وڻ	NOUN	وڻ
وڻن	NOUN	وڻن
يونيورسٽي	NOUN	يونيورسٽي
ٻئي	NOUN	ٻئي
ٻاهر	NOUN	ٻاهر
ٻج	NOUN	ٻج
ٻنيءَ	NOUN	ٻنيءَ
ٻولي	NOUN	ٻولي
ٻوليءَ	NOUN	ٻوليءَ
ٻوڏ	NOUN	ٻوڏ
ٻيڙي	NOUN	ٻيڙي
ٽائيم	NOUN	ٽائيم
ٽهڪ	NOUN	ٽهڪ
ٽي	NOUN	ٽي
ٽڪر	NOUN	ٽڪر
ٽڪري	NOUN	ٽڪري
ٽڪريءَ	NOUN	ٽڪريءَ
پ	NOUN	پ
پئسو	NOUN	پئسو
پابندي	NOUN	پابندي
پارليامينٽ	NOUN	پارليامينٽ
پارٽي	NOUN	پارٽي
پاسي	NOUN	پاسي
پاليسي	NOUN	پاليسي
پاڻيءَ	NOUN	پاڻيءَ
پروگرام	NOUN	پروگرام
پلاننگ	NOUN	پلاننگ
پنن	NOUN	پنن
پوسٽ	NOUN	پوسٽ
پوڙهي	NOUN	پوڙهي
پوڙهيءَ	NOUN	پوڙهيءَ
پوک	NOUN	پوک
پي	NOUN	پي
پيءُ	NOUN	پيءُ
پيش	NOUN	پيش
پين	NOUN	پين
پيٽ	NOUN	پيٽ
پيپلز	NOUN	پيپلز
پيڙائي	NOUN	پيڙائي
پٿر	NOUN	پٿر
پڇ	NOUN	پڇ
پڪ	NOUN	پڪ
ٿائو	NOUN	ٿائو
ٿاڻي	NOUN	ٿاڻي
ڀاءُ	NOUN	ڀاءُ
ڀائرن	NOUN	ڀائرن
ڀتر	NOUN	ڀتر
ڀيرا	NOUN	ڀيرا
ڀيرو	NOUN	ڀيرو
ڀيري	NOUN	ڀيري
ڀٽو	NOUN	ڀٽو
ڄار	NOUN	ڄار
چئلينج	NOUN	چئلينج
چانور	NOUN	چانور
چانورن	NOUN	چانورن
چهنب	NOUN	چهنب
چوڌري	NOUN	چوڌري
چيئرمين	NOUN	چيئرمين
چيتو	NOUN	چيتو
چيتي	NOUN	چيتي
چيف	NOUN	چيف
چين	NOUN	چين
چٻري	NOUN	چٻري
چڪ	NOUN	چڪ
چڪيءَ	NOUN	چڪيءَ
ڇو	NOUN	ڇو
ڇوڪريءَ	NOUN	ڇوڪريءَ
ڊاڪٽر	NOUN	ڊاڪٽر
ڊي	NOUN	ڊي
ڊيسڪ	NOUN	ڊيسڪ
ڊيم	NOUN	ڊيم
ڌر	NOUN	ڌر
ڌرين	NOUN	ڌرين
ڌماڪي	NOUN	ڌماڪي
ڌيءَ	NOUN	ڌيءَ
ڌيان	NOUN	ڌيان
ڍير	NOUN	ڍير
ڍڳن	NOUN	ڍڳن
ڍڳي	NOUN	ڍڳي
ڏس	NOUN	ڏس
ڦو	NOUN	ڦو
کاتي	NOUN	کاتي
کاريءَ	NOUN	کاريءَ
کام	NOUN	کام
کجيءَ	NOUN	کجيءَ
کل	NOUN	کل
کنڊ	NOUN	کنڊ
کيس	NOUN	کيس
ڪ	NOUN	ڪ
ڪئنال	NOUN	ڪئنال
ڪائنات	NOUN	ڪائنات
ڪائو	NOUN	ڪائو
ڪائونسل	NOUN	ڪائونسل
ڪابيرو	NOUN	ڪابيرو
ڪار	NOUN	ڪار
ڪارروائي	NOUN	ڪارروائي
ڪارڪنن	NOUN	ڪارڪنن
ڪاميٽي	NOUN	ڪاميٽي
ڪانگ	NOUN	ڪانگ
ڪاوش	NOUN	ڪاوش
ڪاوڙ	NOUN	ڪاوڙ
ڪاٺير	NOUN	ڪاٺير
ڪردار	NOUN	ڪردار
ڪروڙ	NOUN	ڪروڙ
ڪلاڪ	NOUN	ڪلاڪ
ڪلاڪن	NOUN	ڪلاڪن
ڪلهي	NOUN	ڪلهي
ڪلو	NOUN	ڪلو
ڪميشن	NOUN	ڪميشن
ڪمپا	NOUN	ڪمپا
ڪن	NOUN	ڪن
ڪناري	NOUN	ڪناري
ڪنٽرول	NOUN	ڪنٽرول
ڪوان	NOUN	ڪوان
ڪورٽ	NOUN	ڪورٽ
ڪوٽ	NOUN	ڪوٽ
ڪوڙ	NOUN	ڪوڙ
ڪي	NOUN	ڪي
ڪيس	NOUN	ڪيس
ڪيو	NOUN	ڪيو
ڪيوسڪ	NOUN	ڪيوسڪ
ڪٽار	NOUN	ڪٽار
ڪپڙا	NOUN	ڪپڙا
ڪڙمي	NOUN	ڪڙمي
ڪڙميءَ	NOUN	ڪڙميءَ
ڪڻڪ	NOUN	ڪڻڪ
گاڏين	NOUN	گاڏين
گجگوڙ	NOUN	گجگوڙ
گدڙ	NOUN	گدڙ
گرفتار	NOUN	گرفتار
گرفتاري	NOUN	گرفتاري
گروپ	NOUN	گروپ
گريڊ	NOUN	گريڊ
گنجا	NOUN	گنجا
گهر	NOUN	گهر
گهرن	NOUN	گهرن
گهرو	NOUN	گهرو
گهوڙي	NOUN	گهوڙي
گهڙي	NOUN	گهڙي
گهڙيون	NOUN	گهڙيون
گورنر	NOUN	گورنر
گيلاني	NOUN	گيلاني
ڳالهه	NOUN	ڳالهه
ڳڻتي	NOUN	ڳڻتي
10	NUM	10
12	NUM	12
15	NUM	15
17	NUM	17
2	NUM	2
20	NUM	20
2009ع	NUM	2009ع
24	NUM	24
25	NUM	25
3	NUM	3
30	NUM	30
4	NUM	4
5	NUM	5
50	NUM	50
6	NUM	6
7	NUM	7
8	NUM	8
9	NUM	9
سڀئي	NUM	سڀئي
هڪڙي	NUM	هڪڙي
ٻن	NUM	ٻن
ٻنهي	NUM	ٻنهي
ٽن	NUM	ٽن
ڏهه	NUM	ڏهه
ئي	PART	ئي
به	PART	به
ته	PART	ته
ناهن	PART	ناهن
نه	PART	نه
نٿا	PART	نٿا
نٿو	PART	نٿو
وغيره	PART	وغيره
پڻ	PART	پڻ
ڪونه	PART	ڪونه
آءٌ	PRON	آءٌ
آئون	PRON	آئون
ائين	PRON	ائين
اسان	PRON	اسان
ان	PRON	ان
انهن	PRON	انهن
انهيءَ	PRON	انهيءَ
اها	PRON	اها
اهو	PRON	اهو
اهي	PRON	اهي
اوهين	PRON	اوهين
تنهن	PRON	تنهن
جن	PRON	جن
جنهن	PRON	جنهن
جيڪا	PRON	جيڪا
جيڪو	PRON	جيڪو
جيڪي	PRON	جيڪي
سندس	PRON	سندس
سندن	PRON	سندن
سو	PRON	سو
منهنجا	PRON	منهنجا
هنن	PRON	هنن
هو	PRON	هو
هوءَ	PRON	هوءَ
پنهنجيءَ	PRON	پنهنجيءَ
ڇا	PRON	ڇا
ڇو	PRON	ڇو
ڪا	PRON	ڪا
ڪنهن	PRON	ڪنهن
ڪهڙو	PRON	ڪهڙو
ڪهڙي	PRON	ڪهڙي
ڪو	PRON	ڪو
ڪير	PRON	ڪير
آئرلينڊ	PROPN	آئرلينڊ
آصف	PROPN	آصف
آمريڪا	PROPN	آمريڪا
آڪٽوبر	PROPN	آڪٽوبر
احمد	PROPN	احمد
افغانستان	PROPN	افغانستان
الحرام	PROPN	الحرام
الرحمان	PROPN	الرحمان
القاعده	PROPN	القاعده
ايم	PROPN	ايم
برطانيه	PROPN	برطانيه
بش	PROPN	بش
بلوچستان	PROPN	بلوچستان
بينظير	PROPN	بينظير
بيورو	PROPN	بيورو
جيڪب	PROPN	جيڪب
حسين	PROPN	حسين
حيدرآباد	PROPN	حيدرآباد
خيرپور	PROPN	خيرپور
ذوالفقار	PROPN	ذوالفقار
رضا	PROPN	رضا
سهراب	PROPN	سهراب
سکر	PROPN	سکر
شام	PROPN	شام
شاهه	PROPN	شاهه
طالبان	PROPN	طالبان
عافيه	PROPN	عافيه
عزرائيل	PROPN	عزرائيل
غلام	PROPN	غلام
فقير	PROPN	فقير
فهيم	PROPN	فهيم
قريشي	PROPN	قريشي
لالو	PROPN	لالو
لاهور	PROPN	لاهور
مارئي	PROPN	مارئي
محرم	PROPN	محرم
مرزا	PROPN	مرزا
مشرف	PROPN	مشرف
مهاراج	PROPN	مهاراج
نوابشاهه	PROPN	نوابشاهه
نواز	PROPN	نواز
نومبر	PROPN	نومبر
هليري	PROPN	هليري
وزيرستان	PROPN	وزيرستان
يوسف	PROPN	يوسف
پشاور	PROPN	پشاور
پنجاب	PROPN	پنجاب
پنهور	PROPN	پنهور
ڀارت	PROPN	ڀارت
ڀالوا	PROPN	ڀالوا
ڄامشورو	PROPN	ڄامشورو
ڊسمبر	PROPN	ڊسمبر
ڏکڻ	PROPN	ڏکڻ
ڪراچيءَ	PROPN	ڪراچيءَ
ڪيانگان	PROPN	ڪيانگان
گومبئي	PROPN	گومبئي
گڊو	PROPN	گڊو
ته	SCONJ	ته
جيڪڏهن	SCONJ	جيڪڏهن
پر	SCONJ	پر
ڇاڪاڻ	SCONJ	ڇاڪاڻ
آندو	VERB	آندو
آهيو	VERB	آهيو
آيا	VERB	آيا
آيل	VERB	آيل
آڻڻ	VERB	آڻڻ
ادا	VERB	ادا
ايندي	VERB	ايندي
ايندڙ	VERB	ايندڙ
اٿي	VERB	اٿي
اچ	VERB	اچ
اچن	VERB	اچن
اچو	VERB	اچو
اچڻ	VERB	اچڻ
بيهي	VERB	بيهي
بيٺا	VERB	بيٺا
بيٺل	VERB	بيٺل
بيٺو	VERB	بيٺو
بيٺي	VERB	بيٺي
بچائي	VERB	بچائي
بچائڻ	VERB	بچائڻ
بچايو	VERB	بچايو
بڻجي	VERB	بڻجي
جاري	VERB	جاري
جهلي	VERB	جهلي
جوڙي	VERB	جوڙي
جوڙڻ	VERB	جوڙڻ
داخل	VERB	داخل
رهندي	VERB	رهندي
روانو	VERB	روانو
روڪڻ	VERB	روڪڻ
رکندي	VERB	رکندي
رکڻ	VERB	رکڻ
سمجهيو	VERB	سمجهيو
سوچيو	VERB	سوچيو
سڙي	VERB	سڙي
سگهجي	VERB	سگهجي
سگهن	VERB	سگهن
سگهي	VERB	سگهي
سگهيو	VERB	سگهيو
فوت	VERB	فوت
لهي	VERB	لهي
لڪائي	VERB	لڪائي
لڪي	VERB	لڪي
لڳل	VERB	لڳل
لڳو	VERB	لڳو
لڳڻ	VERB	لڳڻ
مارجي	VERB	مارجي
مري	VERB	مري
ملهايو	VERB	ملهايو
مليا	VERB	مليا
مليل	VERB	مليل
ملڻ	VERB	ملڻ
موڪليو	VERB	موڪليو
هجن	VERB	هجن
هجي	VERB	هجي
هجڻ	VERB	هجڻ
هل	VERB	هل
هلندي	VERB	هلندي
هلندڙ	VERB	هلندڙ
هلي	VERB	هلي
هليا	VERB	هليا
هلڻ	VERB	هلڻ
هنيو	VERB	هنيو
هڻي	VERB	هڻي
واپس	VERB	واپس
وجهي	VERB	وجهي
وراڻيو	VERB	وراڻيو
وسري	VERB	وسري
ويئي	VERB	ويئي
ويندي	VERB	ويندي
ويهي	VERB	ويهي
ويون	VERB	ويون
ويٺل	VERB	ويٺل
ويٺو	VERB	ويٺو
وٺڻ	VERB	وٺڻ
وڃان	VERB	وڃان
وڌي	VERB	وڌي
وڻ	VERB	وڻ
ٺاهڻ	VERB	ٺاهڻ
ٺهي	VERB	ٺهي
ٻاهر	VERB	ٻاهر
ٻڌائي	VERB	ٻڌائي
ٻڌو	VERB	ٻڌو
ٻڌي	VERB	ٻڌي
ٽپ	VERB	ٽپ
پئجي	VERB	پئجي
پائي	VERB	پائي
پهتا	VERB	پهتا
پهتو	VERB	پهتو
پهتي	VERB	پهتي
پهچي	VERB	پهچي
پهچڻ	VERB	پهچڻ
پوندي	VERB	پوندي
پوڻ	VERB	پوڻ
پي	VERB	پي
پيدا	VERB	پيدا
پيش	VERB	پيش
پيل	VERB	پيل
پڇيو	VERB	پڇيو
ٿيل	VERB	ٿيل
ٿيندڙ	VERB	ٿيندڙ
ڀري	VERB	ڀري
ڀريو	VERB	ڀريو
ڀڄي	VERB	ڀڄي
ڀڳو	VERB	ڀڳو
چئي	VERB	چئي
چون	VERB	چون
چيائين	VERB	چيائين
چيس	VERB	چيس
چڙهي	VERB	چڙهي
چڪو	VERB	چڪو
ڇڏيا	VERB	ڇڏيا
ڏئي	VERB	ڏئي
ڏس	VERB	ڏس
ڏسو	VERB	ڏسو
ڏسڻ	VERB	ڏسڻ
ڏنا	VERB	ڏنا
ڏنل	VERB	ڏنل
ڏنو	VERB	ڏنو
ڏنيون	VERB	ڏنيون
ڏيندو	VERB	ڏيندو
کلي	VERB	کلي
کوليو	VERB	کوليو
کپي	VERB	کپي
کڻي	VERB	کڻي
ڪرائي	VERB	ڪرائي
ڪريان	VERB	ڪريان
ڪرڻو	VERB	ڪرڻو
ڪرڻي	VERB	ڪرڻي
ڪونهي	VERB	ڪونهي
ڪيائين	VERB	ڪيائين
ڪيل	VERB	ڪيل
ڪِري	VERB	ڪِري
ڪڍي	VERB	ڪڍي
ڪڍڻ	VERB	ڪڍڻ
گذريل	VERB	گذريل
گذرڻ	VERB	گذرڻ
گهرايو	VERB	گهرايو
گهرجن	VERB	گهرجن
گهرجي	VERB	گهرجي
گهري	VERB	گهري
گهڙي	VERB	گهڙي
گھرجي	VERB	گھرجي
ڳالهائيندي	VERB	ڳالهائيندي
ڳولي	VERB	ڳولي
